########################################
#                                      #
#  ##################################  #
# ##                                ## #
# #    ##########################    # #
# #    #            #           #    # #
# #    #            #           #    # #
# #    #            #           #    # #
# #    ##########################    # #
# #    #            #           #    # #
# #    #            #           #    # #
# #    #            #           #    # #
# #    ##########################    # #
# ##                                ## #
#  ##################################  #
#                                      #
########################################

