########################################
#                                      #
#  ##################################  #
# ##                                ## #
# #                 #                # #
# #                 #                # #
# #                 #                # #
# #                 #                # #
# #  ##############################  # #
# #                 #                # #
# #                 #                # #
# #                 #                # #
# #                 #                # #
# ##                                ## #
#  ##################################  #
#                                      #
########################################

