##################################################
#                                                #
#                      ####                      #
#                      #  #                      #
#                      #  #                      #
#                      ####                      #
#                                                #
#                                                #
#                      **                        #
#                      **                        #
#                                                #
#                                                #
#                                                #
#                                                #
#                                                #
#                                                #
#                                                #
#                                                #
##################################################

